############
#        O #
#       ####
#   P      #
#######    #
#  O ##    #
#    ##    #
#          #
#      XX  #
#      #   #
############
