######
#    #
#  P #
# X  #
#  O #
#####